 NO marin/marin_part1.xpm
 SO marin/marin.xpm
 WE testtext.xpm
 EA east.xpm
 DO door.xpm

 F 50,256,168
 C 189,56,207

111111111111111111111
100000000000000000001
111111111111111111101
100000000000000000101
100000000000000000121
100000000000000000001
100000000000000000001
100000000000000000001
1000000000N0000000001
100000000000000000001
100000000000000000001
111111111111111111111