 NO north.xpm
 SO south.xpm
 WE west.xpm
 EA east.xpm

 F 50,90,168
 C 189,56,207

1111
1N01
1111