 NO north.xpm
 SO south.xpm
 WE west.xpm
 EA east.xpm
 DO door.xpm

 F 50,256,168
 C 189,56,207

 11111111111111111111111
 1232323232E232323233331
 11110000000000023330001
 11111111110000000000001
 11111111111111111111111