 NO north.xpm
 SO south.xpm
 WE west.xpm
 EA east.xpm

 F 50,90,168
 C 189,56,207

11111
1E001
11101
11111