      SO south.xpm
WE west.xpm

 F 50,90,168

 EA east.xpm

 C 189,56,207


   NO north.xpm

11111111111111111111111
10000000000000000000001
10111111111111111110001
101               10001
10111111111111111110001
1000000000W000000000001
11111111111111111111111