 NO assets/north.xpm
 SO assets/south.xpm
 DO assets/evangelion/evangelion_part1.xpm
 WE assets/chrolo/chrolo_part1.xpm
 EA assets/sky/sky_part1.xpm

 F 50,255,168
 C 189,56,207

111111111111111111111
100000000000000000001
111111111111111111101
100000000000000000101
10000000W000000000121
100000000000000000001
100000000000001000001
10000000000001 20002
100000000000001000001
100000000000000000001
100000000000000000001
111111111111111111111