 NO north.xpm
 SO south.xpm
 WE west.xpm
 EA east.xpm

 F 50,90,168
 C 189,56,207

111111111111111111111
100000000000000000001
101010101010101010101
100000000000000000001
100000000000000000001
100000000000000000001
100000000000000000001
100000000000000000001
1000000000N0000000001
100000000000000000001
100000000000000000001
111111111111111111111