 NO north.xpm
 SO south.xpm
 WE west.xpm
 EA east.xpm

 F 50,90,168
 C 189,56,207

111111111111111111111111111
1N0000000000000000000000001
111111111111111111111111101
111111111111111111111111111